EN  RU
Absorb	Поглотить
Activate	Активировать
Add finds	Добавить находки
Add to	Добавить в
Add-House	Добавить-Дом
Add-bottom	Добавить-внизу
Add-mulch	Добавить-мульчу
Adjust	Настроить
Admire	Восхититься
Age	Возраст
Al Kharid	Аль Карид
Align	Выровнять
Ammo	Боезапас
Ancient	Древний
Ancient spellbook	Древняя книга заклинаний
Ancients	Древние
Animate	Оживить
Arceuus	Арцеус
Arceuus spellbook	 Арцеус книга заклинаний
Ardougne	Ардогн
Armour	Доспехи
Ascend	Подняться
Assemble	Собрать
Assignment	Задание
Attach	Прикрепить
Attach-rope	Прикрепить-верёвку
Attack	Атаковать
Attract	Привлечь
Awaken	Пробудить
Background-music	Фоновая-музыка
Bait	Приманка
Balance	Уравнять
Balance-across	Пересечь-балансом
Banish	Изгнать
Bank	Банк
Barbarian Outpost	Деревня варваров
Bars	Прутья
Begin	Начать
Bend	Наклониться
Big Net	Большая сеть
Big-push	Большой-толчок
Big-search	Крупный-поиск
Bind	Связать
Blackout	Отключить свет
Block	Заблокировать
Board	Взойти на борт
Bottom-floor	Нижний этаж
Bow	Поклониться
Breaches	Прорывы
Break	Разломать
Brimhaven	Бримхейвен
Build	Строить
Build mode	Режим строительства
Build on	Строить на
Build-barricade	Поставить-баррикаду
Build-in	Встроить
Burn	Сжечь
Burn-down	Сжечь-до-тла
Burn`	Сжечь`
Burst	Взрыв
Burthorpe	Барторп
Bury	Зарыть
Buy	Купить
Buy-crystals	Купить-кристаллы
Buy-food	Купить-еду
Buy-items	Купить-предметы
Buy-pass	Купить-пропуск
Buy-plank	Купить-доску
Buy-sphere	Купить-сферу
Cage	Поместить в клетку
Call	Позвать
Call-Over	Позвать-Сюда
Camelot	Камелот
Cancel	Отменить
Canyon-count (east)	Проверить-каньон (восток)
Canyon-count (west)	Проверить-каньон (запад)
Capture	Захватить
Carve	Вырезать
Cast	Наложить
Castle Wars	Войны Замков
Catch	Поймать
Cellar	Подвал
Challenge	Вызвать
Challenge-mode	Режим-испытания
Champions' Guild	Гильдия чемпионов
Change	Изменить
Change-clothes	Переодеть
Change-colour	Изменить-цвет
Change-style	Изменить-стиль
Channel	Канал
Channel (Asgarnia)	Канал (Асгарния)
Channel (Fremennik)	Канал (Фременник)
Channel (Great Kourend)	Канал (Большой Коуренд)
Channel (Kandarin)	Канал (Кандарин)
Channel (Karamja)	Канал (Карамджа)
Channel (Kharidian Desert)	Канал (Харидийская пустыня)
Channel (Misthalin)	Канал (Мистхалин)
Channel (Morytania)	Канал (Моритания)
Channel (Tirannwn)	Канал (Тираннвн)
Channel (Wilderness)	Канал (Дикая местность)
Charge	Напасть
Charge-at	Напасть-на
Charm Snake	Очаровать Zмею
Charter	Чартер
Charter-to Aldarin	Чартер-до Алдарина
Charter-to Brimhaven	Чартер-до Бримхейвена
Charter-to Catherby	Чартер-до Катерби
Charter-to Civitas illa Fortis	Чартер-до Civitas illa Fortis
Charter-to Corsair Cove	Чартер-до Бухты Корсаров
Charter-to Land's End	Чартер-до Края Земли
Charter-to Mos Le'Harmless	Чартер-до Мос-Ле-Хармлесс
Charter-to Musa Point	Чартер-до Мыса Муса
Charter-to Port Khazard	Чартер-до Порта Кхазард
Charter-to Port Phasmatys	Чартер-до Порта Фасматис
Charter-to Port Piscarilius	Чартер-до Порта Пискарилиус
Charter-to Port Sarim	Чартер-до Порта Сарим
Charter-to Port Tyras	Чартер-до Порта Тирас
Charter-to Prifddinas	Чартер-до Приффдинас
Charter-to Shipyard	Чартер-до Судоверфи
Charter-to Sunset Coast	Чартер-до Закатного берега
Charter-to Tempestus	Чартер-до Темпестуса
Chase	Преследовать
Check	Проверить
Check Kudos	Проверить Кудос
Check Scores	Проверить Очки
Check charges	Проверить заряд
Check count	Проверить количество
Check for Snakes	Проверить наличие Змей
Check rank	Проверить ранг
Check steps	Проверить шаги
Check-Approval	Проверить-Одобрение
Check-Count	Проверить-Количество
Check-Faith	Проверить-Веру
Check-Fee	Проверить-Плату
Check-ammo	Проверить-боезапас
Check-costume	Проверить-костюм
Check-gates	Проверить-ворота
Check-health	Проверить-здоровье
Check-on	Проверить
Check-permissions	Проверить-права
Check-pets	Проверить-питомцев
Check-statistics (Global)	Проверить статистику (Global)
Check-statistics (Personal)	Проверить статистику (Personal)
Check-times	Проверить время
Chew	Жевать
Chill	Остыть
Chip	Отломать
Choose	Выбрать
Chop	Рубить
Chop down	Срубить
Chop-down	Срубить
Churn	Взбивать
Claim	Заявить
Claim Pet Rock	Получить Питомца Камень
Claim Sand	Получить Песок
Claim-Shield	Получить-Шит
Claim-Tokens	Получить-Жетоны
Claim-arrows	Получить-стрелы
Claim-cape	Получить-плащ
Claim-log-rewards	Получить-награды-за-бревна
Claim-runes	Получить-руны
Claim-slime	Получить-слизь
Claim-staves	Получить-посохи
Claim-trophies	Получить-трофеи
Clamber	Взобраться
Clean	Очистить
Cleanse	Очищать
Clear	Очистить
Climb	Залезть
Climb Down	Спуститься
Climb Up	Подняться
Climb down	Спуститься
Climb over	Перелезть
Climb through	Проползти
Climb up	Подняться
Climb-across	Перелезть через
Climb-down	Спускаться
Climb-down (normal)	Спуск (обычно)
Climb-down (private)	Спуск (частный)
Climb-into	Залезть-внутрь
Climb-off	Слезть
Climb-on	Залезть-на
Climb-over	Перелезть
Climb-rope	Влезть-по-верёвке
Climb-through	Проползти-через
Climb-through (normal)	Пролаз (обычно)
Climb-through (private)	Пролаз (частный)
Climb-to	Подняться-на
Climb-under	Проползти-под
Climb-up	Залезть-вверх
Climp-up	Подняться
Clip	Отрезать
Close	Закрыть
Coffer	Сейф
Collapse	Обрушить
Collect	Собрать
Collect-from	Забрать-у
Collect-items	Забрать-предметы
Collections overview	Обзор коллекций
Colour	Цвет
Commission	Комиссия
Commune	Общаться
Complete	Завершить
Configuration	Конфигурация
Configure	Настроить
Confront	Противостоять
Conjure	Заклинать
Construct	Конструировать
Continue	Продолжить
Continue-trek	Продолжить-поход
Contract	Контракт
Control	Управлять
Convert	Преобразовать
Convert-shards	Преобразовать-осколки
Cook	Готовить
Cook-at	Готовить-в
Cooking Guild	Кулинарная гильдия
Cool-preform	Охладить-заготовку
Corporeal Beast	Телесное Чудовище
Count	Посчитать
Count-plunder	Подсчитать-трофеи
Crack	Вскрыть
Craft	Создать
Craft-goods	Создавать-товары
Craft-rune	Вырабатывать-руну
Crafting Guild	Гильдия Ремесленников
Crawl	Ползти
Crawl through	Проползти-через
Crawl-down	Сползти-вниз
Crawl-through	Проползти
Crawl-under	Проползти-под
Crazy	Безумный
Cross	Пересечь
Cross-bridge	Перейти-мост
Cross-to	Перейти-в
Cure	Исцелить
Cut	Отрезать
Cut down	Срубить
Cut-Down	Отрезать
Cut-branch	Отрезать-ветку
Cut-foot	Отрезать-ступню
Cut-vine	Отрезать-лозу
Cut-wood	Рубить-древесину
Dance	Танцевать
Deactivate	Деактивировать
Deboard	Сойти с корабля
Debug	Отладить
Decant	Перелить
Decapitate	Обезглавить
Demolish	Снести
Deposit	Внести
Deposit-All    Внести-Все
Deposit-X      Внести-X
Deposit buckets	Положить вёдра
Deposit-box	Депозитная-коробка
Deposit-items	Положить-предметы
Deposit-pickaxe	Сдать-кирку
Deposit-runes	Вложить-руны
Descend	Спуститься
Destroy	Уничтожить
Detach	Отсоединить
Detatch	Отсоединить
Devices	Устройства
Dig	Копать
Dig-below	Копать-ниже
Dig-up	Выкопать
Digsite	Раскопки
Direct-portal	Направить-портал
Directions	Направления
Disable	Отключить
Disarm	Обезвредить
Discard	Выбросить
Disembark	Высадиться
Dismantle	Разобрать
Dismantle kit	Разобрать комплект
Dismiss	Отозвать
Dispel	Рассейть
Display	Показать
Dissolve	Растворить
Distract	Отвлечь
Disturb	Побеспокоить
Dive	Нырнуть
Dive in	Нырнуть внутрь
Divine	Божественный
Dondakan's Rock	Скала Дондакан
Douse	Залить
Drain	Осушить
Draynor Village	Деревня Дрейнор
Dream	Мечтать
Drink	Пить
Drink-from	Пить-из
Drop	Выбросить
Dump	Сбросить
Dunk	Окунуть
Dunk-preform	Окунать-заготовку
Dyes	Краски
Easter dance	Пасхальный танец
Eat	Съесть
Edgeville	Эджвилл
Emir's Arena	Арена Эмира
Emote	Эмоция
Empty	Опустошить
Empty Bowl	Опорожнить чашу
Empty Dish	Опорожнить тарелку
Empty-Out	Опорожнить
Enchant	Зачаровать
Enter	Войти
Enter-cloud	Войти-в-облако
Enter-corrupted	Войти-коррумпировано
Enter-crypt	Войти-в-гробницу
Enter-guest	Войти-как-гость
Enter-member	Войти-как-участник
Entertain	Развлечь
Equip	Надеть
Escape	Сбежать
Escape-event	Событие-побега
Escort	Эскортировать
Evade	Избежать
Evade-event	Событие-уклонения
Events	События
Examine	Осмотреть
Excavate	Раскопать
Exchange	Обменять
Exchange fire cape	Обменять плащ огня
Exit	Выйти
Exit-cave	Покинуть-пещеру
Exit-through	Выйти-через
Exit-through (Kourend)	Выйти-через (Коуренд)
Extinguish	Тушить
Falador Park	Парк Фаладор
Farming Guild	Фермерская гильдия
Feed	Кормить
Feel	Почувствовать
Ferox Enclave	Анклав Ферокс
Ferry	Паром
Fight	Сражаться
Fill	Наполнить
Fill-bucket	Наполнить-ведро
Fill-from	Наполнить-из
Fill-jug	Наполнить-кувшин
Fire	Поджечь
Fire!	Огонь!
Fire-at	Огонь-по
Fish	Ловить рыбу
Fish-In	Ловить-в
Fishing Guild	Рыболовная гильдия
Fix	Починить
Fix-exoskeleton	Починить-экзоскелет
Flip	Перевернуть
Float Canoe	Отплыть на Каноэ
Float Log	Сплавить Бревно
Flush	Промыть
Fly	Лететь
Follow	Следовать
Force	Принудить
Forfeit	Отказаться
Fossil Island	Остров Окаменелостей
Free	Освободить
Friend's house	Дом друга
Fry	Жарить
Fuel	Топливо
Fur Clothing	Меховая одежда
Fur-clothing	Меховая-одежда
Gauntlets	Рукавицы
Gaze-into	Вглядеться
Gear	Экипировка
Get bird	Взять птицу
Get in	Войти
Get job (easy)	Выполнить задание (легко)
Get job (hard)	Выполнить задание (трудно)
Get-Spikes	Взять-шипы
Get-down	Спуститься
Get-log	Взять-бревно
Get-rewards	Получить-награды
Give-Stick	Дать-палку
Give-Sword	Дать-меч
Glade	Полянка
Glider	Планер
Glider-to Gandius	Планер-до Гандиуса
Glider-to Kar-Hewo	Планер-до Кар-Хэво
Glider-to Lemanto Andra	Планер-до Леманто Андра
Glider-to Lemantolly Undri	Планер-до Лемантолли Ундри
Glider-to Ookookolly Undri	Планер-до Укукуолли Ундри
Glider-to Sindarpos	Планер-до Синдарпоса
Glider-to Ta Quir Priw	Планер-до Та Кир Прив
Gloomthorn Trail	Тропа Глумторн
Go-down	Спуститься
Go-inside	Войти-внутрь
Go-through	Пройти-через
Go-up	Подняться
Grab	Схватить
Grab-feather	Взять-перо
Grand Exchange	Великая Биржа
Grapple	Схватиться
Guess-letter	Угадать-букву
Guide	Провести
Hack	Взломать
Haircut	Стрижка
Hammer	Молоток
Hand-in	Сдать
Harpoon	Гарпун
Harvest	Собрать урожай
Heal	Исцелить
Heart	Сердце
Heat-preform	Нагреть-заготовку
Help	Помощь
Hide-behind	Спрятаться-за
Hide-in	Скрыться-внутри
History	История
Hit	Ударить
Hold	Держать
Holiday-items	Праздничные-предметы
Home	Дом
Honour	Честь
Hoop	Обруч
Hurdle	Барьер
Iceberg	Айсберг
Imbue	Наделить силой
Inferno	Инферно
Inflate	Надуть
Info	Информация
Inject	Ввести
Inspect	Осмотреть
Insult	Оскорбить
Interact	Взаимодействовать
Intimidate	Запугать
Investigate	Расследовать
Invoke	Призвать
Island of Stone	Остров Камня
Items	Предметы
Jars	Банки
Jatizso	Ятизсо
Join	Присоединиться
Join Castle Wars	Присоединиться к Войнам Замков
Join-Crew	Вступить-в-команду
Join-Team	Присоединиться-к-команде
Jump	Прыгнуть
Jump off	Прыгнуть вниз
Jump on	Прыгнуть на
Jump to	Перепрыгнуть к
Jump-Down	Спрыгнуть-Вниз
Jump-Over	Перепрыгнуть-Через
Jump-To	Прыгнуть-К
Jump-across	Перепрыгнуть-через
Jump-down	Спрыгнуть-вниз
Jump-from	Прыгнуть-с
Jump-in	Прыгнуть-внутрь
Jump-off	Спрыгнуть
Jump-on	Прыгнуть-на
Jump-onto	Запрыгнуть-на
Jump-over	Перепрыгнуть-через
Jump-through	Прыгнуть-через
Jump-to	Прыгнуть-к
Jump-up	Прыгнуть-вверх
Karamja	Карамджа
Kastori	Кастори
Kick	Пнуть
Kill	Убить
Kill Area	Зона убийства
Kill Bot	Уничтожить бота
Kill-count	Считать-убийства
Kitten	Котёнок
Knock-Out	Нокаутировать
Knock-at	Постучать-в
Land's End	Край Земли
Lap-count	Счёт-кругов
Last-destination	Последний-пункт
Leave	Уйти
Leave Cavern	Покинуть пещеру
Leave Tomb	Покинуть гробницу
Leave platform	Покинуть платформу
Leave-area	Покинуть-область
Leave-tutorial	Покинуть-обучение
Level	Уровень
Lift	Поднять
Light	Зажечь
Listen	Слушать
Listen-at	Слушать-у
Listen-to	Слушать
Lithkren	Литкрен
Load	Загрузить
Locate	Найти
Lock	Запереть
Locking	Запирание
Lockpick	Взломать замок
Locks	Замки
Log-storage	Хранилище бревен
Look	Посмотреть
Look at	Посмотреть на
Look in	Заглянуть внутрь
Look out	Посмотреть наружу
Look-at	Посмотреть-на
Look-in	Посмотреть-внутри
Look-in-all	Посмотреть-всё
Look-inside	Посмотреть-внутрь
Look-into	Вглядеться-в
Look-through	Просмотреть
Look-under	Посмотреть-под
Look-up	Посмотреть-вверх
Loop	Цикл
Loot	Грабить
Lunar	Лунный
Lunar spellbook	Лунная книга заклинаний
Lure	Приманить
Make	Сделать
Make scary noise	Издать страшный звук
Make unfinished potion(s)	Приготовить незавершённое зелье(я)
Make-Canoe	Сделать-Kаноэ
Make-helmet	Сделать-шлем
Make-raft	Сделать-плот
Makeover	Преображение
Manoeuvre-past	Маневрировать-мимо
Mark	Отметить
Mash	Размять
Maxhit Variant	Вариант Mаксхит
Medic	Медик
Melt	Расплавить
Metamorph	Метаморф
Metamorphosis	Метаморфоза
Milk	Доить
Mine	Добывать
Mines	Шахты
Mining Guild	Гильдия Шахтёров
Miscellania	Мисцеллания
Monastery	Монастырь
Move	Переместить
Murder	Убийство
Navigate	Навигировать
Neitiznot	Нейтизнот
Net	Сеть
Nets	Сети
New-maze	Новый-лабиринт
Observe	Наблюдать
Offer-fish	Предложить-рыбу
Open	Открыть
Open (normal)	Открыть (обычно)
Open (private)	Открыть (частный)
Open Adventure Paths	Открыть Пути Приключений
Operate	Работать
Options	Настройки
Other-services	Другие-услуги
Paddle Canoe	Грести Каноэ
Paddle Log	Грести Бревно
Pan	Жарить
Pass	Пройти
Pass (normal)	Пройти (обычно)
Pass (private)	Пройти (частный)
Pass through	Пройти сквозь
Pass-Through	Пройти-Сквозь
Pass-through	Пройти-сквозь
Pass-to	Пройти-к
Pay	Заплатить
Pay (Celastrus tree)	Заплатить (Целаструс дерево)
Pay (Fruit tree)	Заплатить (Фруктовое дерево)
Pay (Redwood tree)	Заплатить (Красное дерево)
Pay (Spirit tree)	Заплатить (Духовое дерево)
Pay (north)	Заплатить (север)
Pay (north-east)	Заплатить (северо-восток)
Pay (north-west)	Заплатить (северо-запад)
Pay (south)	Заплатить (юг)
Pay (south-east)	Заплатить (юго-восток)
Pay (south-west)	Заплатить (юго-запад)
Pay (tree patch)	Заплатить (участок дерева)
Pay-Fare	Оплатить-Проезд
Pay-fare	Оплатить-проезд
Pay-toll(10gp)	Оплатить-сбор (10зм)
Pay-toll(2-Ecto)	Оплатить-сбор (2-Екто)
Pedal	Крутить педали
Peek	Заглянуть
Peek (normal)	Заглянуть (обычно)
Peel	Очистить
Peer-into	Заглянуть-внутрь
Peer-through	Просмотреть-через
Perks	Преимущества
Pet	Питомец
Pick	Собрать
Pick Banana	Сорвать Банан
Pick Nuts	Собрать Орехи
Pick up	Поднять
Pick-Fruit	Сорвать-Фрукт
Pick-Lock	Взломать-Замок
Pick-apple	Сорвать-яблоко
Pick-banana	Сорвать-банан
Pick-coconut	Сорвать-кокос
Pick-dragonfruit	Сорвать-драконий фрукт
Pick-from	Взять-из
Pick-fruit	Сорвать-фрукт
Pick-leaf	Собрать-лист
Pick-lock	Взломать-замок
Pick-lots	Собрать-много
Pick-orange	Сорвать-апельсин
Pick-pineapple	Сорвать-ананас
Pick-pocket	Карманная-кража
Pick-spine	Вырвать-шип
Pick-up	Поднять
Pickle	Мариновать
Picklock	Взломать
Pickpocket	Обокрасть
Pickup	Подбор
Pirate's Cove	Пиратская Бухта
Place	Поместить
Place-cell	Поместить-в-ячейку
Plant	Посадить
Plant-orb	Посадить-сферу
Play	Играть
Play-quietly	Играть-тихо
Play-with	Играть-с
Pluck	Сорвать
Plunder	Разграбить
Poach	Браконьерствовать
Poke	Толкнуть
Pop	Всплыть
Port Piscarilius	Порт Пискарилиус
Port Sarim	Порт Сарим
Potions	Зелья
Pour	Налить
Power-up	Включить-питание
Pray	Молиться
Pray-at	Помолиться-у
Preach	Проповедовать
Preen	Чистить
Preferences	Настройки
Prepare-fish	Подготовить-рыбу
Press	Нажать
Prices	Цены
Private	Приватный
Proceed	Продолжить
Prod	Подтолкнуть
Prospect	Перспектировать
Prune	Обрезать
Prune-back	Обрезать-назад
Prune-sides	Обрезать-стороны
Prune-top	Обрезать-верх
Pull	Тянуть
Pull-down	Тянуть-вниз
Pull-spade	Тянуть-лопату
Pump	Насос
Purchase Amulet	Купить Амулет
Push	Толкнуть
Push-against	Толкнуть-против
Push-through	Протолкнуть
Push-up	Отжиматься
Put-inside	Положить-внутрь
Put-ore-on	Положить-руду-на
Quench-preform	Закалить-заготовку
Question	Опросить
Quick Pass	Быстрый-Проход
Quick-Board	Быстрая-Посадка
Quick-Enter	Быстрый-Вход
Quick-Exit	Быстрый-Выход
Quick-Pass	Быстрый-Проход
Quick-Pay(100)	Быстрая-Оплата (100)
Quick-Travel	Быстрое-Перемещение
Quick-Use	Быстрое-использование
Quick-board	Быстрая-посадка
Quick-climb	Быстрый-подъём
Quick-enter	Быстрый-вход
Quick-escape	Быстрое-спасение
Quick-exit	Быстрый-выход
Quick-falcon	Быстрый-сокол
Quick-leave	Быстрый-уход
Quick-lock	Быстрая-блокировка
Quick-open	Быстро-открыть
Quick-pass	Быстрый-проход
Quick-start	Быстрый-старт
Quick-travel	Быстрое-перемещение
Quick-use	Быстрое-использование
Quick-withdraw	Быстрое-снятие
Rake	Сгрести
Ranging Guild	Гильдия Стрелков
Rank	Ранг
Ransack	Ограбить
Re-light	Заново-зажечь
Reach	Достичь
Read	Прочитать
Read (Awakened)	Прочитать (Пробуждённое)
Read-tag	Прочитать-метку
Rebalance	Перебалансировать
Recharge-jewellery	Зарядить-украшение
Recharge-whistle	Зарядить-свисток
Recoil settings	Настройки отдачи
Redecorate	Редекорировать
Redeem	Обменять
Redeem-code	Активировать-код
Refine	Очистить
Refuel	Дозаправить
Reinforce	Укрепить
Release	Выпустить
Release-bees	Выпустить-пчёл
Rellekka	Реллека
Relocate	Переместить
Reminisce	Вспомнить
Remove	Снять
Remove PvP Protection	Убрать защиту PvP
Remove board advert	Удалить объявление на доске
Remove-Bone	Удалить-Кость
Remove-Pot	Удалить-Горшок
Remove-banner	Удалить-баннер
Remove-coal	Удалить-уголь
Remove-decorations	Удалить-украшения
Remove-outfit	Удалить-костюм
Remove-room	Удалить-комнату
Remove-trophy	Удалить-трофей
Repair	Ремонтировать
Repairs	Ремонт
Request-supplies	Запросить-припасы
Reset	Сбросить
Reset-room	Сбросить-комнату
Reset-time	Сбросить-время
Reset-wave	Сбросить-волну
Resign	Отказаться
Rest	Отдохнуть
Retrieve	Извлечь
Retrieve-egg	Забрать-яйцо
Return	Вернуть
Return-Home	Вернуться-Домой
Return-to-Burgh	Вернуться-в-Берг
Return-to-Paterdomus	Вернуться-в-Патердомус
Reverse	Развернуть
Revert	Вернуть
Rewards	Награды
Ride	Ездить
Rimmington	Риммингтон
Ring	Кольцо
Ring-Zanaris	Кольцо-Занарис
Ring-bell	Звонить-в-колокол
Ring-configure	Кольцо-настроить
Ring-last-destination (AIP)	Кольцо-последний-пункт (AIP)
Ring-last-destination (AIQ)	Кольцо-последний-пункт (AIQ)
Ring-last-destination (AIR)	Кольцо-последний-пункт (AIR)
Ring-last-destination (AIS)	Кольцо-последний-пункт (AIS)
Ring-last-destination (AJP)	Кольцо-последний-пункт (AJP)
Ring-last-destination (AJQ)	Кольцо-последний-пункт (AJQ)
Ring-last-destination (AJR)	Кольцо-последний-пункт (AJR)
Ring-last-destination (AJS)	Кольцо-последний-пункт (AJS)
Ring-last-destination (AKP)	Кольцо-последний-пункт (AKP)
Ring-last-destination (AKQ)	Кольцо-последний-пункт (AKQ)
Ring-last-destination (AKR)	Кольцо-последний-пункт (AKR)
Ring-last-destination (AKS)	Кольцо-последний-пункт (AKS)
Ring-last-destination (ALP)	Кольцо-последний-пункт (ALP)
Ring-last-destination (ALQ)	Кольцо-последний-пункт (ALQ)
Ring-last-destination (ALR)	Кольцо-последний-пункт (ALR)
Ring-last-destination (ALS)	Кольцо-последний-пункт (ALS)
Ring-last-destination (BIP)	Кольцо-последний-пункт (BIP)
Ring-last-destination (BIQ)	Кольцо-последний-пункт (BIQ)
Ring-last-destination (BIR)	Кольцо-последний-пункт (BIR)
Ring-last-destination (BIS)	Кольцо-последний-пункт (BIS)
Ring-last-destination (BJP)	Кольцо-последний-пункт (BJP)
Ring-last-destination (BJQ)	Кольцо-последний-пункт (BJQ)
Ring-last-destination (BJR)	Кольцо-последний-пункт (BJR)
Ring-last-destination (BJS)	Кольцо-последний-пункт (BJS)
Ring-last-destination (BKP)	Кольцо-последний-пункт (BKP)
Ring-last-destination (BKQ)	Кольцо-последний-пункт (BKQ)
Ring-last-destination (BKR)	Кольцо-последний-пункт (BKR)
Ring-last-destination (BKS)	Кольцо-последний-пункт (BKS)
Ring-last-destination (BLP)	Кольцо-последний-пункт (BLP)
Ring-last-destination (BLQ)	Кольцо-последний-пункт (BLQ)
Ring-last-destination (BLR)	Кольцо-последний-пункт (BLR)
Ring-last-destination (BLS)	Кольцо-последний-пункт (BLS)
Ring-last-destination (CIP)	Кольцо-последний-пункт (CIP)
Ring-last-destination (CIQ)	Кольцо-последний-пункт (CIQ)
Ring-last-destination (CIR)	Кольцо-последний-пункт (CIR)
Ring-last-destination (CIS)	Кольцо-последний-пункт (CIS)
Ring-last-destination (CJP)	Кольцо-последний-пункт (CJP)
Ring-last-destination (CJQ)	Кольцо-последний-пункт (CJQ)
Ring-last-destination (CJR)	Кольцо-последний-пункт (CJR)
Ring-last-destination (CJS)	Кольцо-последний-пункт (CJS)
Ring-last-destination (CKP)	Кольцо-последний-пункт (CKP)
Ring-last-destination (CKQ)	Кольцо-последний-пункт (CKQ)
Ring-last-destination (CKR)	Кольцо-последний-пункт (CKR)
Ring-last-destination (CKS)	Кольцо-последний-пункт (CKS)
Ring-last-destination (CLP)	Кольцо-последний-пункт (CLP)
Ring-last-destination (CLQ)	Кольцо-последний-пункт (CLQ)
Ring-last-destination (CLR)	Кольцо-последний-пункт (CLR)
Ring-last-destination (CLS)	Кольцо-последний-пункт (CLS)
Ring-last-destination (DIP)	Кольцо-последний-пункт (DIP)
Ring-last-destination (DIQ)	Кольцо-последний-пункт (DIQ)
Ring-last-destination (DIR)	Кольцо-последний-пункт (DIR)
Ring-last-destination (DIS)	Кольцо-последний-пункт (DIS)
Ring-last-destination (DJP)	Кольцо-последний-пункт (DJP)
Ring-last-destination (DJQ)	Кольцо-последний-пункт (DJQ)
Ring-last-destination (DJR)	Кольцо-последний-пункт (DJR)
Ring-last-destination (DJS)	Кольцо-последний-пункт (DJS)
Ring-last-destination (DKP)	Кольцо-последний-пункт (DKP)
Ring-last-destination (DKQ)	Кольцо-последний-пункт (DKQ)
Ring-last-destination (DKR)	Кольцо-последний-пункт (DKR)
Ring-last-destination (DKS)	Кольцо-последний-пункт (DKS)
Ring-last-destination (DLP)	Кольцо-последний-пункт (DLP)
Ring-last-destination (DLQ)	Кольцо-последний-пункт (DLQ)
Ring-last-destination (DLR)	Кольцо-последний-пункт (DLR)
Ring-last-destination (DLS)	Кольцо-последний-пункт (DLS)
Roll	Катать
Rotate	Повернуть
Rotate-anticlockwise	Повернуть-против-часовой
Rotate-clockwise	Повернуть-по-часовой
Rub	Тереть
Rummage	Перерыть
Rumour	Слух
Rumour-settings	Настройки-слухов
Sacrifice	Пожертвовать
Sacrifice-fragments	Пожертвовать-фрагменты
Sand	Песок
Say-name	Сказать-имя
Scale	Масштабировать
Scare	Напугать
Scare-away	Отпугнуть
Scatter	Рассыпать
Scoreboard	Табло
Scramble	Перемешать
Scry	Вглядываться
Search	Искать
Search for traps	Искать ловушки
Search-for-traps	Искать-ловушки
Seeds	Семена
Seers' Village	Деревня Ясновидцев
Send-parcel	Отправить-посылку
Serve	Обслуживать
Set Destination	Установить Назначения
Set destination	Установить назначения
Set up	Настроить
Set-difficulty	Установить-сложность
Set-trap	Поставить-ловушку
Set-up	Настроить
Sets	Наборы
Settings	Настройки
Settings/Destroy	Настройки/Удалить
Setup	Настройка
Setups	Настройки
Sew	Шить
Shake	Потрясти
Shape-Canoe	Формировать-каноэ
Shared	Общий
Shave	Побриться
Shear	Стричь
Shoo	Прогнать
Shoo-away	Прогнать-прочь
Shoot	Стрелять
Shoot-at	Стрелять-в
Shop	Магазин
Shout-over	Кричать-через
Shout-to	Крикнуть-кому-то
Show-Goal	Показать-цель
Shut	Закрыть
Sing	Петь
Sing-crystal	Спеть-кристаллу
Sit-On	Сесть-на
Sit-on	Сесть-на
Skin	Снять кожу
Skull	Череп
Slash	Порезать
Slayer	Убийца
Sleep-in	Спать-внутри
Slice	Нарезать
Slide	Скольжение
Small Net	Малая Сеть
Smash	Разбить
Smash-ice	Разбить-лед
Smash-to-bits	Разбить-в-клочья
Smell	Понюхать
Smelt	Переплавить
Smith	Ковать
Smoke	Коптить
Sniff	Обнюхать
Snow	Снег
Sober-Up	Отрезветь
Solo-start	Начать-соло
Spawn Item	Создать предмет
Spectate	Наблюдать
Spellbook	Книга заклинаний
Spin	Крутить
Spin-globe	Вращать-глобус
Squeeze-past	Пройти-мимо
Squeeze-through	Пройти-сквозь
Stamp-out	Вытоптать
Stand-on	Встать-на
Standard	Стандарт
Standard Variant	Стандартный Вариант
Standard spellbook	Стандартная книга заклинаний
Start	Начать
Start-minigame	Начать-мини-игру
Start-wave	Начать-волну
Statistics	Статистика
Stats	Характеристики
Status	Статус
Staves	Посохи
Steal	Украсть
Steal from	Украсть у
Steal-From	Украсть-У
Steal-cowbell	Украсть-коровий-колокольчик
Steal-from	Украсть-у
Step-into	Шагнуть-внутрь
Step-off	Шагнуть-вон
Step-on	Наступить-на
Step-over	Перепрыгнуть
Stock-Up	Пополнить-запас
Store	Хранить
Store-plunder	Сохранить-трофеи
Store-preform	Сохранить-заготовку
Story	История
Strike	Удар
Stroke	Погладить
Study	Изучать
Stun	Оглушить
Suck	Высосать
Summon	Призвать
Supply	Поставлять
Swap	Поменять местами
Swap-options	Поменять-опции
Swim	Плавать
Swim to	Плыть до
Swing	Качаться
Swing Across	Перекатиться Через
Swing across	Перекатиться через
Swing-across	Перекатиться-через
Swing-from	Качаться-с
Swing-on	Качаться-на
Tackle	Отобрать
Tag	Тегнуть
Take	Взять
Take From	Взять У
Take Rake	Взять Грабли
Take Seed Dibber	Взять Садовый Инструмент
Take Spade	Взять Лопату
Take anglerfish	Взять англерфиш
Take down	Снять
Take manta ray	Взять манту
Take pages	Взять страницы
Take tools	Взять инструменты
Take treasure	Взять сокровище
Take-1	Взять-1
Take-10	Взять-10
Take-10 concoctions	Взять-10-зелий
Take-5	Взять-5
Take-5 concoctions	Взять-5-зелий
Take-Arrows	Взять-Стрелы
Take-Beam	Взять-Балку
Take-Coffin	Взять-Гроб
Take-Crackers	Взять-Хлопушки
Take-Log	Взять-Бревно
Take-Meat	Взять-Мясо
Take-Pulley-Beam	Взять-Блок-Балку
Take-Rope	Взять-Верёвку
Take-Rum	Взять-Ром
Take-Runes	Взять-Руны
Take-Tofu	Взять-Тофу
Take-Tool	Взять-Инструмент
Take-Vial	Взять-Флакон
Take-Worms	Взять-Червей
Take-X	Взять-X
Take-axe	Взять-топор
Take-beer	Взять-пиво
Take-boat	Взять-лодку
Take-bowl	Взять-миску
Take-candy	Взять-конфету
Take-chisel	Взять-долото
Take-concoction	Взять-зелье
Take-cutting	Взять-кусок
Take-flyer	Взять-листовку
Take-from	Взять-из
Take-hammer	Взять-молоток
Take-kettle	Взять-чайник
Take-knife	Взять-нож
Take-lure	Взять-приманку
Take-net	Взять-сеть
Take-pickaxe	Взять-кирку
Take-powder	Взять-порошок
Take-preform	Взять-заготовку
Take-remains	Взять-останки
Take-rock	Взять-камень
Take-seed	Взять-семя
Take-sigil	Взять-печатку
Take-supplies	Взять-припасы
Take-tinderbox	Взять-кресало
Tal Teklan	Тал Теклан
Talk	Поговорить
Talk to	Поговорить с
Talk-At	Поговорить-К
Talk-To	Поговорить-С
Talk-into	Поговорить-В
Talk-to	Поговорить-с
Tamper	Подкрутить
Tan-hides	Дубить-шкуры
Tap	Коснуться
Task	Задача
Tears of Guthix	Слёзы Гатикса
Tease	Дразнить
Teeth-grip	Сжать-зубами
Tele	Теле
Teleport	Телепорт
Teleport Menu	Меню телепортации
Teleport menu	Меню телепортации
Teleport to Destination	Телепортироваться к пункту Назначения
Teleport to destination	Телепортироваться к пункту назначения
Tend-to	Ухаживать
Tether	Привязать
Threaten	Угрожать
Throw	Бросить
Throw-at	Бросить-в
Tickets	Билеты
Tie-rope	Привязать-верёвку
Toggle	Переключить
Toggle Counter	Переключить Счётчик
Toggle Fossils	Переключить Окаменелости
Toggle K/D	Переключить К/Д
Toggle XP	Переключить ОП
Toggle warning	Переключить предупреждение
Toggle warnings	Переключить предупреждения
Toggle-minerals	Переключить-минералы
Toggle-talisman	Переключить-талисман
Toggle-vials	Переключить-фиалки
Toggle-warning	Переключить-предупреждение
Top-Floor	Верхний-Этаж
Top-floor	Верхний-этаж
Touch	Прикоснуться
Trade	Торговать
Trade-Builders-Store	Торговать-в-Магазине-Строителей
Trade-Co-op	Торговать-в-кооп
Trade-Drinks	Торговать-Напитками
Trade-General-Store	Торговать-в-Общем-Магазине
Trade-in	Обменять
Trade with	Торговать с
Training	Тренировка
Transform	Преобразовать
Translate	Перевести
Transport	Транспортировать
Trap	Поставить-ловушку
Travel	Путешествовать
Travel to platform	Отправиться на платформу
Travel-End	Пути-Конец
Travel-Start	Пути-Начало
Tread-softly	Идти-тихо
Tree	Дерево
Trick-or-treat	Сладость-или-гадость
Turn	Повернуть
Turn-Off	Выключить
Tutorial	Учебник
Tuxedo-time	Время-смокинга
Unblock	Разблокировать
Uncharge	Разрядить
Ungael	Унгайел
Unlock	Разблокировать
Unmark	Снять метку
Untether	Освободить от привязи
Untie	Развязать
Upgrade	Улучшить
Use	Использовать
Use-Driftwood	Использовать-Плот
Use-Lift	Использовать-Подъёмник
Use-Logs	Использовать-Бревна
Use-rod	Использовать-удочку
Value	Ценить
Varrock	Варрок
Vault	Хранилище
Venerate	Почитать
Vent	Вентиляция
View	Просмотреть
View Laps	Просмотреть Круги
View Stats	Просмотреть Характеристики
View-game	Просмотреть-игру
View-trophies	Просмотреть-трофеи
Visit-Last	Посетить-Последний
Visual-effects	Визуальные-эффекты
Wake-ghost	Разбудить-привидение
Walk	Идти
Walk here	Идти здесь
Walk on	Идти по
Walk through	Пройти через
Walk-Down	Идти-Вниз
Walk-Up	Идти-Вверх
Walk-across	Перейти-через
Walk-along	Идти-вдоль
Walk-down	Идти-вниз
Walk-on	Идти-по
Walk-over	Перейти-через
Walk-past	Пройти-мимо
Walk-through	Пройти-через
Walk-up	Идти-вверх
Warm-by	Согреться-у
Warriors' Guild	Гильдия Воинов
Watch	Смотреть
Watch-shouting	Наблюдать-крики
Watchtower	Сторожевая башня
Water	Полить
Waterbirth Island	Остров Ватерберф
Watermill	Водяная мельница
Waterproof	Водонепроницаемый
Wear	Надеть
Weave	Ткать
Weed	Прополоть
Weiss	Вейсс
Whack	Ударить
Wield	Держать
Wind	Намотать
Wind-up	Завести
Wintertodt Camp	Лагерь Винтертодт
Withdraw-All    Снять-Все
Withdraw-X      Снять-X
Withdraw-All-but-1  Снять-Все-кроме-1
Withdraw	Снять
Woodcutting Guild	Гильдия Лесорубов
Work-at	Работать-над
Worship	Почитать
Yanille	Янилле
Zanaris	Занарис
talk	разговаривать
test	тест